consistent	adj. 一致的
battery	n. 电池
competent	adj. 能胜任的，有能力的
preserve	v. 保存，保护
possession	n. 拥有
proximately	adv. 近似，接近
wildfire	n. 野火
compact	adj. 紧密的，紧凑的
defy	v. 违背，违抗
absolutely	adv. 当然
filter	v. 过滤
server	n. 服务器
spoil	v. 溺爱
rustle	v. 发出沙沙声
diversion	n. 转移；娱乐
complaint	n. 抱怨，投诉
merge	v. 合并
priceless	adj. 无价的，难以用价格衡量的
honorary	adj. 荣誉的
chronic	adj. 长期的；慢性的
extracurricular	adj. 课外的
lobby	n. 游说
inexhaustible	adj. 用不完的，无穷无尽的
inevitable	adj. 不可避免的